 18 22 22 22 22 22 22 22 22 22 22 22 22 22 22 22 22 22 22 22 22 22 22 22 22 22 22 22 22 22 22 22 22 22 22 22 22 22 22 22 22 22 22 22 22 22 18 
21 15 15 15 15 15 15 16 15 15 15 15 15 15 15 16 15 15 15 15 15 15 15 15 15 15 15 16 15 15 15 15 15 15 16 15 15 15 15 15 15 15 15 15 15 15 21 
21 15 15 15 15 15 15 16 15 15 15 15 15 15 15 16 15 15 15 15 15 15 15 15 15 15 15 16 15 15 15 15 15 15 16 15 15 15 15 15 15 15 15 15 15 15 21 
21 15 15 15 15 15 15 16 15 15 15 15 15 15 15 16 15 15 15 15 15 15 15 15 15 15 15 16 15 15 15 15 15 15 16 15 15 15 15 15 15 15 15 15 15 15 21 
21 15 15 15 15 15 15 16 15 15 15 15 15 15 15 16 15 15 15 15 15 15 15 15 15 15 15 16 15 15 15 15 15 15 16 15 15 15 15 15 15 15 15 15 15 15 21 
21 15 15 15 15 15 15 16 15 15 15 15 15 15 15 16 15 15 15 15 15 15 15 15 15 15 15 16 15 15 15 15 15 15 16 15 15 15 15 15 15 15 15 15 15 15 21 
21 15 15 15 15 15 15 16 15 15 15 15 15 15 15 16 15 15 15 15 15 15 15 15 15 15 15 16 15 15 15 15 15 15 16 15 15 15 15 15 15 15 15 15 15 15 21 
21 15 15 15 15 15 15 16 15 15 15 15 15 15 15 16 15 15 15 15 15 15 15 15 15 15 15 16 15 15 15 15 15 15 16 15 15 15 15 15 15 15 15 15 15 15 21 
21 15 15 15 15 15 15 16 15 15 15 15 15 15 15 16 15 15 15 15 15 15 15 15 15 15 15 16 15 15 15 15 15 15 16 15 15 15 15 17 17 17 15 15 15 15 21 
21 15 15 15 15 15 15 16 15 15 15 15 15 15 15 16 15 15 15 15 15 15 15 15 15 15 15 16 15 15 15 15 15 15 16 15 15 15 15 17 17 17 15 15 15 15 21 
21 15 15 15 15 15 15 19 15 15 15 15 15 15 15 19 15 15 15 15 15 15 15 15 15 15 15 19 15 15 15 15 15 15 19 15 15 15 15 17 17 17 15 15 15 15 21 
21 15 15 15 15 15 15 16 15 15 15 15 15 15 15 16 15 15 15 15 15 15 15 15 15 15 15 16 15 15 15 15 15 15 16 15 15 15 15 17 17 17 15 15 15 15 21 
21 15 15 15 15 15 15 16 15 15 15 15 15 15 15 16 15 15 15 15 15 15 15 15 15 15 15 16 15 15 15 15 15 15 16 15 15 15 15 17 17 17 15 15 15 15 21 
21 15 15 15 15 15 15 16 15 15 15 15 15 15 15 16 15 15 15 15 15 15 15 15 15 15 15 16 15 15 15 15 15 15 16 15 15 15 15 15 15 15 15 15 15 15 21 
21 15 15 15 15 15 15 16 15 15 15 15 15 15 15 16 15 15 15 15 15 15 15 15 15 15 15 16 15 15 15 15 15 15 16 15 15 15 15 15 15 15 15 15 15 15 21 
21 15 15 15 15 15 15 16 15 15 15 15 15 15 15 16 15 15 15 15 15 15 15 15 15 15 15 16 15 15 15 15 15 15 16 15 15 15 15 15 15 15 15 15 15 15 21 
21 15 15 15 15 15 15 16 15 15 15 15 15 15 15 16 15 15 15 15 15 15 15 15 15 15 15 16 15 15 15 15 15 15 16 15 15 15 15 15 15 15 15 15 15 15 21 
21 15 15 15 15 15 15 16 15 15 15 15 15 15 15 16 15 15 15 15 15 15 15 15 15 15 15 16 15 15 15 15 15 15 16 15 15 15 15 15 15 15 15 15 15 15 21 
21 15 15 15 15 15 15 16 15 15 15 15 15 15 15 16 15 15 15 15 15 15 15 15 15 15 15 16 15 15 15 15 15 15 16 15 15 15 15 15 15 15 15 16 16 16 21
21 15 15 15 15 15 15 16 15 15 15 15 15 15 15 16 15 15 15 15 15 15 15 15 15 15 15 16 15 15 15 15 15 15 16 15 15 15 15 15 15 15 15 16 14 16 21
21 15 15 15 15 15 15 16 15 15 15 15 15 15 15 16 15 15 15 15 15 15 15 15 15 15 15 16 15 15 15 15 15 15 16 15 15 15 15 15 15 15 15 16 16 16 21
18 22 22 22 22 22 22 22 22 22 22 22 22 22 22 22 22 22 22 22 22 22 22 22 22 22 22 22 22 22 22 22 22 22 22 22 22 22 22 22 22 22 22 22 22 22 18