8  8  8  8  8  8  8  8  8  8  8  8  8  8  8  8  8  8  8  8  8  8  8  5    3  3  3  3  3  3  3  3  3  3    3  3  3  11    8  8  8  8  8  8  8  8
8  8  8  8  8  8  8  8  8  8  8  8  8  8  8  8  8  8  8  8  8  8  8  1  0  0  0  0  0  0  0  0  0  0  0  0  0  2  8  8  8  8  8  8  8  8    
8  8  8  8  8  8  8  8  8  8  8  8  8  8  8  8  8  8  8  8  8  8  8  1  0  0  0  0  0  0  0  0  0  0  0  0  0  2  8  8  8  8  8  8  8  8    
8  8  8  8  8  8  8  8  8  8  8  8  8  8  8  8  8  8  8  8  8  8  8  1  0  0  0  0  0  0  0  0  0  0  0  0  0  2  8  8  8  8  8  8  8  8    
8  8  8  8  8  8  8  8  8  8  8  8  8  8  8  8  8  8  8  8  8  8  8  1  0  0  0  0  0  0  0  0  0  0  0  0  0  2  8  8  8  8  8  8  8  8    
8  8  8  8  8  8  8  8  8  8  8  8  8  8  8  8  8  8  8  8  8  8  8  1  0  0  0  0  0  0  0  0  0  0  0  0  0  2  8  8  8  8  8  8  8  8    
8  8  8  8  8  8  8  8  8  8  8  8  8  8  8  8  8  8  8  8  8  8  8  1  0  0  0  0  0  0  0  0  0  0  0  0  0  2  8  8  8  8  8  8  8  8    
8  8  8  8  8  8  8  8  8  8  8  8  8  8  8  8  8  8  8  8  8  8  8  1  0  0  0  0  0  0  0  0  0  0  0  0  0  2  8  8  8  8  8  8  8  8    
8  8  8  8  8  8  8  8  8  8  8  8  8  8  8  8  8  8  8  8  8  8  8  1  0  0  0  0  0  0  0  0  0  0  0  0  0  2  8  8  8  8  8  8  8  8    
8  8  8  8  8  8  8  8  8  8  8  8  8  8  8  8  8  8  8  8  5  3  3  1  0  0  0  0  0  0  0  0  0  0  0  0  0  2  8  8  8  8  8  8  8  8    
8  8  8  8  8  8  8  8  8  8  8  8  8  8  8  8  8  8  8  8  1  14    0  1  0  0  0  0  0  0  0  0  0  0  0  0  0  2  8  8  8  8  8  8  8  8
8  8  8  8  8  8  8  8  8  8  8  8  8  8  8  8  8  8  8  8  1  0  0  1    0  0  0  0  0  0  0  0  0  0  0  0  0  2  8  8  8  8  8  8  8  8
8  8  8  8  8  8  8  8  8  8  8  8  8  8  8  8  8  8  8  8  7  4  4  1  0  0  0  0  0  0  0  0  0  0  0  0  0  2  8  8  8  8  8  8  8  8    
8  8  8  8  8  8  8  8  8  8  8  8  8  8  8  8  8  8  8  8  8  8  8  1  0  0  0  0  0  0  0  0  0  0  0  0  0  2  8  8  8  8  8  8  8  8    
8  8  8  8  8  8  8  8  8  8  8  8  8  8  8  8  8  8  8  8  8  8  8  1  0  0  0  0  0  0  0  0  0  0  0  0  0  2  8  8  8  8  8  8  8  8    
8  8  8  8  8  8  8  8  8  8  8  8  8  8  8  8  8  8  8  8  8  8  8  1  0  0  0  0  0  0  0  0  0  0  0  0  0  2  8  8  8  8  8  8  8  8    
8  8  8  8  8  8  8  8  8  8  8  8  8  8  8  8  8  8  8  8  8  8  8  1  0  0  0  0  0  0  0  0  0  0  0  0  0  2  8  8  8  8  8  8  8  8    
8  8  8  8  8  8  8  8  8  8  8  8  8  8  8  8  8  8  8  8  8  8  8  1  0  0  0  0  0  0  0  0  0  0  0  0  0  2  8  8  8  8  8  8  8  8    
8  8  8  8  8  8  8  8  8  8  8  8  8  8  8  8  8  8  8  8  8  8  8  1  0  0  0  0  0  0  0  0  0  0  0  0  0  2  8  8  8  8  8  8  8  8    
8  8  8  8  8  8  8  8  8  8  8  8  8  8  8  8  8  8  8  8  8  8  8  1  0  0  0  0  0  0  0  0  0  0  0  0  0  2  8  8  8  8  8  8  8  8    
8  8  8  8  8  8  8  8  8  8  8  8  8  8  8  8  8  8  8  8  8  8  8  7  1  12  7  4  4  4  4  4  4  4  4  4  4  6  8  8  8  8  8  8  8  8
8  8  8  8  8  8  8  8  8  8  8  8  8  8  8  8  8  8  8  8  8  8  8  1  1  0  2  8  8  8  8  8  8  8  8  8  8  8  8  8  8  8  8  8  8  8    
8  8  8  8  8  8  8  8  8  8  8  8  8  8  8  8  8  5  3  3  3  3  3  5  1  0  5  3  3  3  3  11    8  8  8  8  8    5  3  3  3  3  3  3  3  11    
5  3  3  3  3  3  3  3  3  3  11  8  8  8  8  8  8    1  0  0  0  0  0  0  0  0  0  0  0  0  0  2  8  8  8  8  8  1  0  0  0  0  0  0  0  2    
1  0  0  0  0  0  0  0  0  0  2  8  8  8  8  8  8  1  0  0  0  0  0  0  0  0  0  0  0  0  0  2  8  8  8  8  8  1  0  0  0  0  0  0  0  2    
1  0  0  0  0  0  0  0  0  0  2  8  8  8  8  8  8  1  0  0  0  0  0  0  0  0  0  0  0  0  0  2  8  8  8  8  8  1  0  0  0  0  0  0  0  2    
1  0  0  0  0  0  0  0  0  0  2  8  8  8  8  8  8  1  0  0  0  0  0  0  0  0  0  0  0  0  0  2  8  8  8  8  8  1  0  0  0  0  0  0  0  2    
1  0  0  0  0  0  0  0  0  0  2  8  8  8  8  8  8  1  0  0  0  0  0  0  0  0  0  0  0  0  0  2  8  8  8  8  8  1  0  0  0  0  0  0  0  2    
1  0  0  0  0  0  0  0  0  0  7  4  4  4  4  4  4  1  0  0  0  0  0  0  0  0  0  0  0  0  0  7  4  4  4  4  4  1  0  0  0  0  0  0  0  2    
1  0  0  0  0  0  0  0  0  0  9  0  0  0  0  0  0  9  0  0  0  7  1  0  0  0  7  1  0  0  0  9  0  0  0  0  0  9  0  0  0  0  0  0  0  2    
1  0  0  0  0  0  0  0  0  0  10    0  0  0  0  0  0  10    0  0  0  5  1  0  0  0  5  1  0  0  0  10    0  0  0  0  0  10    0  0  0  0  0  0  0  2    
1  0  0  0  0  0  0  0  0  0  5  3  3  3  3  3  3  1  0  0  0  0  0  0  0  0  0  0  0  0  0  5  3  3  3  3  3  1  0  0  0  0  0  0  0  2    
1  0  0  0  0  0  0  0  0  0  2  8  8  8  8  8  8  1  0  0  0  0  0  0  0  0  0  0  0  0  0  2  8  8  8  8  8  1  0  0  0  0  0  0  0  2    
1  0  0  0  0  0  0  0  0  0  2  8  8  8  8  8  8  1  0  0  0  0  0  0  0  0  0  0  0  0  0  2  8  8  8  8  8  1  0  0  0  0  0  0  0  2    
1  0  0  0  0  0  0  0  0  0  2  8  8  8  8  8  8  1  0  0  0  0  0  0  0  0  0  0  0  0  0  2  8  8  8  8  8  1  0  0  0  0  0  0  0  2    
1  0  0  0  0  0  0  0  0  0  2  8  8  8  8  8  8  1  0  0  0  0  0  0  0  0  0  0  0  0  0  2  8  8  8  8  8  1  0  0  0  0  0  0  0  2    
7  4  4  4  1  0  7  4  4  4  6  8  8  8  8  8  8  1  0  0  0  0  0  0  0  0  0  0  0  0  0  2  8  8  8  8  8  1  0  0  0  0  0  0  0  2    
8  8  8  8  1  0  2  8  8  8  8  8  8  8  8  8  8  7  4  4  4  4  4  4  1  0  7  4  4  4  4  6  8  8  8  8  8  7  4  4  4  4  4  4  4  6    
8  8  8  8  1  0  2  8  8  8  8  8  8  8  8  8  8  8  8  8  8  8  8  8  1  0  2  8  8  8  8  8  8  8  8  8  8  8  8  8  8  8  8  8  8  8    
8  8  8  8  1  0  2  8  8  8  8  8  8  8  8  8  8  8  8  8  8  8  8  8  1  0  2  8  8  8  8  8  8  8  8  8  8  8  8  8  8  8  8  8  8  8    
8  8  8  8  1  0  2  8  8  8  8  8  8  8  8  8  8  8  8  8  8  8  8  8  1  0  2  8  8  8  8  8  8  8  8  8  8  8  8  8  8  8  8  8  8  8    
8  8  8  8  1  0  2  8  8  8  8  8  8  8  8  8  8  8  8  8  8  8  8  8  1  0  2  8  8  8  8  8  8  8  8  8  8  8  8  8  8  8  8  8  8  8    
8  8  8  8  1  0  2  8  8  8  8  8  8  8  8  8  8  8  8  8  8  8  8  8  1  0  2  8  8  8  8  8  8  8  8  8  8  8  8  8  8  8  8  8  8  8    
5  3  3  3  1  0  5  3  3  3  11    8  8  8  8  8  8  5  3  3  3  3  3  3  1  0  5  3  3  3  3  11    8  8  8  8  8  8  8  8  8  8  8  8  8  8    
1  0  0  0  0  0  0  0  0  0  2  8  8  8  8  8  8  1  0  0  0  0  0  0  0  0  0  0  0  0  0  2  8  8  8  8  8  8  8  8  8  8  8  8  8  8    
1  0  0  0  0  0  0  0  0  0  2  8  8  8  8  8  8  1  0  0  0  0  0  0  0  0  0  0  0  0  0  2  8  8  8  8  8  8  8  8  8  8  8  8  8  8    
1  0  0  0  0  0  0  0  0  0  2  8  8  8  8  8  8  1  0  0  0  0  0  0  0  0  0  0  0  0  0  2  8  8  8  8  8  8  8  8  8  8  8  8  8  8    
1  0  0  0  0  0  0  0  0  0  2  8  8  8  8  8  8  1  0  0  0  0  0  0  0  0  0  0  0  0  0  2  8  8  8  8  8  8  8  8  8  8  8  8  8  8    
1  0  0  0  0  0  0  0  0  0  7  4  4  4  4  4  4  1  0  0  0  0  0  0  0  0  0  0  0  0  0  2  8  8  8  8  8  8  8  8  8  8  8  8  8  8    
1  0  0  0  0  0  0  0  0  0  9  0  0  0  0  0  0  9  0  0  0  7  1  0  0  0  0  0  0  0  0  2  8  8  8  8  8  8  8  8  8  8  8  8  8  8    
1  0  0  0  0  0  0  0  0  0  10    0  0  0  0  0  0  10  0  0  0  5  1  0  0  0    0  0  0  0  0  2  8  8  8  8  8  8  8  8  8  8  8  8  8  8    
1  0  0  0  0  0  0  0  0  0  5  3  3  3  3  3  3  1  0  0  0  0  0  0  0  0    0  0  0  0  0    2    8  8  8  8  8  8  8  8  8  8  8  8  8  8    
1  0  0  0  0  0  0  0  0  0  2  8  8  8  8  8  8  1  0  0  0  0  0  0  0  0  0  0  0  0  0  2  8  8  8  8  8  8  8  8  8  8  8  8  8  8    
1  0  0  0  0  0  0  0  0  0  2  8  8  8  8  8  8  1  0  0  0  0  0  0  0  0  0  0  0  0  0  2  8  8  8  8  8  8  8  8  8  8  8  8  8  8    
1  0  0  0  0  0  0  0  0  0  2  8  8  8  8  8  8  1  0  0  0  0  0  0  0  0  0  0  0  0  0  2  8  8  8  8  8  8  8  8  8  8  8  8  8  8    
1  0  0  0  0  0  0  0  0  0  2  8  8  8  8  8  8  1  0  0  0  0  0  0  0  0  0  0  0  0  0  2  8  8  8  8  8  8  8  8  8  8  8  8  8  8    
7  4  4  4  4  4  4  4  4  4  6  8  8  8  8  8  8  7  4  4  4  4  4  4  4  4  4  4  4  4  4  6  8  8  8  8  8  8  8  8  8  8  8  8  8  8    