24 24 24 24 24 24 24 24 24 24 24 24 23 30 30 30 30 30 30 30 30 30 30 23 24 24 24 24 24 24 24 24 24 24 24 24 24 24 24 24 24 24 24 24 24 24 24 24 24  
24 24 24 24 24 24 24 24 24 24 24 24 27 25 25 25 25 25 25 25 25 25 25 28 24 24 24 24 24 24 24 24 24 24 24 24 24 24 24 24 24 24 24 24 24 24 24 24 24  
24 24 24 24 24 24 24 24 24 24 24 24 27 25 25 25 25 25 25 25 25 25 25 28 24 24 24 24 24 24 24 24 24 24 24 24 24 24 24 24 24 24 24 24 24 24 24 24 24  
24 24 24 24 24 24 24 24 24 24 24 24 27 25 25 25 25 25 25 25 25 25 25 28 24 24 24 24 23 23 23 23 23 23 23 23 23 23 23 23 23 23 23 23 23 23 23 23 24  
24 24 24 24 24 24 24 24 24 24 24 24 27 25 25 25 25 25 25 25 25 25 25 28 24 24 24 24 23 34 34 34 34 34 34 34 34 34 34 34 34 34 34 34 34 34 34 23 24  
24 24 24 24 24 24 24 24 24 24 24 24 27 25 25 25 25 25 25 25 25 25 25 28 24 24 24 24 23 34 34 34 34 34 34 34 34 34 34 34 34 34 34 34 34 34 34 23 24  
24 24 24 24 24 24 24 24 24 24 24 24 27 25 25 25 25 25 25 25 25 25 25 28 24 24 24 24 23 34 34 34 34 34 34 34 34 34 34 34 34 34 34 34 34 34 34 23 24  
24 24 24 24 24 24 24 24 24 24 24 24 27 25 25 25 25 25 25 25 25 25 25 28 24 24 24 24 23 34 34 34 34 34 34 34 34 34 34 34 34 34 34 34 34 34 34 23 24  
24 24 24 24 24 24 24 24 24 24 24 24 27 25 25 25 25 25 25 25 25 25 25 28 24 24 24 24 23 34 34 34 34 34 34 34 34 34 34 34 34 34 34 34 34 34 34 23 24  
23 30 30 30 30 30 30 30 30 30 23 23 30 30 30 30 30 30 30 30 30 30 32 30 30 30 30 30 23 23 34 34 34 34 34 34 34 34 34 34 34 34 34 34 34 34 34 34 23
27 25 25 25 25 25 25 25 25 25 28 27 25 25 25 25 25 25 25 25 25 25 25 25 25 25 25 25 28 26 34 34 34 34 34 34 34 34 34 34 34 34 34 34 34 34 34 34 23  
27 25 25 25 25 25 25 25 25 25 28 27 25 25 25 25 25 25 25 25 25 25 25 25 25 25 25 25 28 26 34 34 34 34 34 34 34 34 34 34 34 34 34 34 34 34 34 34 23  
27 25 25 25 25 25 25 25 25 25 28 27 25 25 25 25 25 25 25 25 25 25 25 25 25 25 25 25 28 26 34 34 34 34 34 34 34 34 34 34 34 34 34 34 34 34 34 34 23  
27 25 25 25 25 25 25 25 25 25 28 27 25 25 25 25 25 25 25 25 25 25 25 25 25 25 25 25 28 26 34 34 34 34 34 34 34 34 34 34 34 34 34 34 34 34 34 34 23  
27 25 25 25 25 25 25 25 25 26 33 26 25 25 25 25 25 25 25 25 25 25 25 25 25 25 25 26 33 26 34 34 34 34 34 34 34 34 34 34 34 34 34 34 34 34 34 34 23
27 25 25 25 25 25 25 25 25 25 28 27 25 25 25 25 25 25 25 25 25 25 25 25 25 25 25 25 28 26 34 34 34 34 34 34 34 34 34 34 34 34 34 34 34 34 34 23 14
27 25 25 25 25 25 25 25 25 25 28 27 25 25 25 25 25 25 25 25 25 25 25 25 25 25 25 25 28 26 34 34 34 34 34 34 34 34 34 34 34 34 34 34 34 34 34 34 23  
27 25 25 25 25 25 25 25 25 25 28 27 25 25 25 25 25 25 25 25 25 25 25 25 25 25 25 25 28 26 34 34 34 34 34 34 34 34 34 34 34 34 34 34 34 34 34 34 23  
27 25 25 25 25 25 25 25 25 25 28 27 25 25 25 25 25 25 25 25 25 25 25 25 25 25 25 25 28 26 34 34 34 34 34 34 34 34 34 34 34 34 34 34 34 34 34 34 23  
23 29 29 29 29 29 29 29 29 29 23 23 29 29 29 29 29 29 29 29 29 29 32 29 29 29 29 29 23 23 34 34 34 34 34 34 34 34 34 34 34 34 34 34 34 34 34 34 23
24 24 24 24 24 24 24 24 24 24 24 24 27 25 25 25 25 25 25 25 25 25 25 25 28 24 24 24 24 23 34 34 34 34 34 34 34 34 34 34 34 34 34 34 34 34 34 34 23  
24 24 24 24 24 24 24 24 24 24 24 24 27 25 25 25 25 25 25 25 25 25 25 25 28 24 24 24 24 23 34 34 34 34 34 34 34 34 34 34 34 34 34 34 34 34 34 34 23  
24 24 24 24 24 24 24 24 24 24 24 24 27 25 25 25 25 25 25 25 25 25 25 25 28 24 24 24 24 23 34 34 34 34 34 34 34 34 34 34 34 34 34 34 34 34 34 34 23  
24 24 24 24 24 24 24 24 24 24 24 24 27 25 25 25 25 25 25 25 25 25 25 25 28 24 24 24 24 23 34 34 34 34 34 34 34 34 34 34 34 34 34 34 34 34 34 34 23  
24 24 24 24 24 24 24 24 24 24 24 24 27 25 25 25 25 25 25 25 25 25 25 25 28 24 24 24 24 23 34 34 34 34 34 34 34 34 34 34 34 34 34 34 34 34 34 34 23  
24 24 24 24 24 24 24 24 24 24 24 24 27 25 25 25 25 25 25 25 25 25 25 25 28 24 24 24 24 23 23 23 23 23 23 23 23 23 23 23 23 23 23 23 23 23 23 23 23  
24 24 24 24 24 24 24 24 24 24 24 24 27 25 25 25 25 25 25 25 25 25 25 25 28 24 24 24 24 24 24 24 24 24 24 24 24 24 24 24 24 24 24 24 24 24 24 24 24  
24 24 24 24 24 24 24 24 24 24 24 24 27 25 25 25 25 25 25 25 25 25 25 25 28 24 24 24 24 24 24 24 24 24 24 24 24 24 24 24 24 24 24 24 24 24 24 24 24  
24 24 24 24 24 24 24 24 24 24 24 24 23 29 29 29 29 29 29 29 29 29 29 29 23 24 24 24 24 24 24 24 24 24 24 24 24 24 24 24 24 24 24 24 24 24 24 24 24